                             +-----+    
                             |.....|    
      #######################=.....|    
      #                #     |.....|    
      #                #     |.....|    
 +----=----------+     #     +-----+    
 |...............|     #                
 |...............=######                
 |...............|                      
 +---------------+                      
